Name,Volume,Ask Size,Ask Price,Bid Size,Bid Price,Last Price,Shares Matched,Shares Routed
MSTZ,20473425,200,0.99,5,0.99,0.99,19907043,566382
ETHU,1552202,100,9.77,51,9.74,9.76,1540918,11284
UVIX,1186973,1302,3.24,2959,3.21,3.24,1147026,39947
BITX,1048042,100,60.65,4,60.56,60.62,1035947,12095
NVDQ,973798,475,3.38,14811,3.36,3.38,973676,122
IEFA,957619,1,74.02,25,72.70,73.63,947974,9645
NVDX,722549,108,17.43,110,17.37,17.38,715170,7379
UVXY,712475,100,19.37,400,19.27,19.36,700502,11973
INDA,705204,1,54.93,1,54.81,54.89,703944,1260
MSTU,665944,132,164.77,8,164.34,164.44,662621,3323
FBTC,572169,1400,85.42,1200,85.01,85.07,571241,928
IGV,491724,2,105.85,5,104.50,104.84,489494,2230
USMV,443607,2,94.79,0,0.00,94.75,438457,5150
VXX,310962,764,42.56,39,42.51,42.54,286863,24099
EFV,305924,0,0.00,1,53.59,54.74,305924,0
USHY,291259,50,38.40,38,37.51,37.53,290509,750
ARKG,283681,62,25.95,10,25.90,25.95,278012,5669
ARKB,248596,600,97.31,1200,97.04,97.52,248214,382
SVIX,241410,50,29.52,1,28.03,29.39,227961,13449
NOBL,209415,10,109.21,5,108.00,108.64,208823,592
QUAL,185401,2,186.00,1,185.00,185.29,185286,115
CBOE,178578,68,221.80,23,213.80,215.16,177662,916
GSST,154692,0,0.00,0,0.00,50.46,154692,0
ITB,137720,5,128.20,1,123.82,123.70,136687,1033
GOVT,136416,177,24.00,1,22.91,22.91,136358,58
FETH,120739,5700,36.09,1600,35.84,35.72,118663,2076
IYZ,120235,1,27.92,1,25.50,27.74,120235,0
BBJP,117421,14,59.70,14,54.05,57.65,112365,5056
EZU,107096,1,47.99,0,0.00,47.95,106737,359
COWZ,96567,2,63.00,1,55.21,60.87,96567,0
MTUM,87799,62,220.00,2,216.00,216.52,86771,1028
VIXY,85716,100,42.14,5,41.86,41.95,69855,15861
AAAU,82789,16,26.31,40,26.20,26.20,81670,1119
DFIC,74908,0,0.00,267,26.00,26.85,71923,2985
HYD,73886,0,0.00,10,49.75,52.85,73886,0
IYT,70076,0,0.00,24,71.00,74.72,70076,0
PAVE,67641,3,57.50,1,45.71,45.73,67270,371
SVXY,65062,105,53.28,100,53.01,53.10,61455,3607
BOXX,56924,200,109.88,4115,109.81,109.81,46788,10136
MOAT,56462,83,100.00,5,98.40,98.44,56462,0
GNOV,56397,0,0.00,0,0.00,35.31,56397,0
BBEU,50777,1,63.38,0,0.00,57.86,50508,269
VNM,50345,276,11.78,67,11.76,11.78,49745,600
QDTE,50254,289,42.70,1,42.63,42.70,49887,367
BTCW,49623,900,103.62,1900,102.90,103.24,49570,53
RDVI,48556,0,0.00,25,24.81,26.30,48556,0
CALF,47435,1,49.90,72,47.60,49.40,47074,361
CETH,45441,11000,18.03,11000,17.83,17.93,45018,423
BBHY,44522,0,0.00,0,0.00,47.09,44522,0
ESGV,44003,1,125.00,40,104.00,107.50,43508,495
FLOT,43461,7150,51.08,100,51.06,51.08,43261,200
SPYI,38594,2,52.38,500,52.28,52.28,38593,1
MAMB,37675,0,0.00,0,0.00,22.88,24049,13626
FRDM,36660,0,0.00,5,31.82,33.35,36660,0
KNG,35500,100,188.88,10,54.34,54.35,35400,100
HEFA,35009,3,36.00,2,34.00,35.19,35009,0
BTCZ,33740,9093,5.82,1700,5.79,5.78,32860,880
GOVZ,32601,1,20.84,0,0.00,11.12,32601,0
XDTE,32192,4,53.45,2,53.05,53.15,31992,200
PICK,31507,11,41.00,1,39.30,39.71,29453,2054
ICSH,31210,12000,50.66,303,50.64,50.64,31210,0
REM,30789,153,23.41,35,21.99,23.23,30734,55
EFAV,30603,0,0.00,0,0.00,73.88,29232,1371
BBUS,30547,1,114.00,21,99.00,109.07,30547,0
VUSB,29870,50,49.84,1000,49.80,49.81,25176,4694
DFIS,29046,0,0.00,91,24.26,25.39,29046,0
ARKX,28464,1,20.27,1,20.04,20.20,27885,579
JCPB,28382,0,0.00,1,42.12,47.20,28382,0
JBBB,28329,0,0.00,0,0.00,49.41,28329,0
ITA,27788,4,155.88,9,155.06,155.88,27778,10
IAGG,27308,5,56.00,0,0.00,52.28,27208,100
ICF,26713,8,66.98,25,62.86,65.35,26713,0
MPRO,26107,0,0.00,0,0.00,30.06,17328,8779
EFG,26036,0,0.00,0,0.00,101.11,25834,202
HODL,25794,1000,110.57,1000,109.81,110.42,19894,5900
LVHI,25790,0,0.00,30,31.00,31.42,25490,300
BDEC,25329,0,0.00,0,0.00,43.77,25329,0
PDEC,25161,0,0.00,1,3.00,38.83,25161,0
IDV,23710,1,30.00,88,28.20,28.64,23687,23
RDTE,22788,700,45.59,51,45.46,45.46,22788,0
BBCA,22594,0,0.00,1,70.00,75.45,22365,229
IVVB,22377,0,0.00,0,0.00,31.39,22377,0
IBHE,22203,0,0.00,0,0.00,23.27,22203,0
TLTW,21889,249,25.43,3,25.42,25.43,21889,0
FBCG,20699,0,0.00,0,0.00,46.01,20699,0
ECH,19409,27,26.30,4,25.24,25.35,19409,0
BBAX,18325,0,0.00,0,0.00,52.35,18195,130
IFRA,17623,30,54.50,0,0.00,51.80,17622,1
JCPI,17067,0,0.00,0,0.00,47.36,17067,0
EEMV,16864,8,69.00,0,0.00,59.83,15093,1771
ARKQ,16776,10,77.25,10,76.93,77.15,16776,0
ICVT,16655,100,90.00,6,82.55,89.28,16655,0
VFMO,16014,504,209.00,3,153.41,178.14,13661,2353
ITM,15969,0,0.00,1,40.36,46.66,15969,0
ESML,15866,0,0.00,4104,16.92,45.73,15866,0
OMFL,15683,0,0.00,200,49.49,55.56,13826,1857
IGEB,15111,0,0.00,0,0.00,45.59,15111,0
JMUB,15025,0,0.00,0,0.00,50.97,15025,0
XIJN,14800,0,0.00,0,0.00,30.98,14800,0
DIHP,14531,0,0.00,0,0.00,26.22,14531,0
JMST,14525,0,0.00,0,0.00,50.90,14525,0
BTCO,14157,1200,97.88,1200,97.01,97.01,14157,0
VLUE,14043,2,118.00,0,0.00,114.56,13758,285
EUAD,13908,0,0.00,0,0.00,25.15,13908,0
BALT,13903,0,0.00,0,0.00,31.38,13402,501
EZBC,13826,3700,56.70,2000,56.24,56.48,13826,0
BTCL,13195,200,58.26,100,56.74,56.85,13195,0
HOCT,13007,0,0.00,0,0.00,23.92,13007,0
XVV,12811,0,0.00,0,0.00,46.51,12811,0
NEAR,12684,0,0.00,50,50.40,50.84,12469,215
FLHY,12656,0,0.00,0,0.00,24.27,12656,0
CNYA,12569,1000,32.00,10,21.00,29.14,12569,0
TYA,12557,0,0.00,15,12.30,13.16,12557,0
BUFR,12287,0,0.00,1,30.61,30.68,12287,0
MSFX,12203,77,26.97,400,26.62,26.80,12203,0
DISV,12073,80,27.89,0,0.00,27.35,12073,0
ACWV,11812,0,0.00,0,0.00,115.42,11812,0
IBHF,11038,0,0.00,500,23.11,23.33,11038,0
HYDB,10177,201,51.85,0,0.00,47.96,9836,341
LOCT,9929,0,0.00,0,0.00,23.85,9929,0
LAPR,9900,0,0.00,0,0.00,25.16,9900,0
SMIN,9858,6,88.58,61,82.75,83.02,9008,850
HJUL,9200,0,0.00,0,0.00,24.06,9200,0
HAPR,9007,0,0.00,0,0.00,25.21,9007,0
VIXM,8800,1,15.08,53,13.68,13.74,8788,12
BBRE,8519,50,108.00,1,95.00,102.19,8119,400
ISPY,8369,50,46.34,1,45.77,45.95,8369,0
MLN,8013,3400,18.50,0,0.00,18.27,8013,0
DRAG,7954,30,21.15,100,20.02,21.03,7954,0
GCOW,7627,34,37.30,5,34.43,35.45,7627,0
ADFI,7625,0,0.00,0,0.00,8.62,7625,0
PSFF,7623,0,0.00,0,0.00,29.34,7623,0
ICLO,7542,90,25.69,10,25.60,25.64,7542,0
SLVP,7466,50,13.03,20,12.02,12.97,7466,0
TMFC,7463,40,64.20,300,59.60,59.99,7463,0
TMFS,7339,162,39.75,100,37.00,39.74,7339,0
FLBL,7313,0,0.00,308,24.20,24.44,7313,0
SMMD,7228,0,0.00,0,0.00,73.94,7228,0
VTEI,6919,0,0.00,0,0.00,100.75,6919,0
XNOV,6913,0,0.00,0,0.00,34.31,6913,0
ICOW,6905,0,0.00,0,0.00,30.25,6905,0
YBTC,6726,420,53.50,1,50.01,51.00,6466,260
QMNV,6719,0,0.00,0,0.00,20.18,6719,0
VSGX,6657,1,60.50,8,58.50,58.81,6657,0
FPFD,6560,26,22.51,0,0.00,21.95,6460,100
NANC,6296,1,40.12,3,39.64,39.93,6296,0
DIVB,6250,400,52.20,1,47.95,50.95,6250,0
NOVM,6233,0,0.00,0,0.00,30.68,6233,0
XSHD,6190,21,22.18,50,15.25,15.63,6190,0
HYIN,5909,10,19.35,40,18.50,18.65,5891,18
IWMI,5867,0,0.00,500,52.11,55.89,5867,0
EMHY,5831,25,39.69,31,32.55,38.98,5506,325
GVI,5813,15,115.42,0,0.00,105.43,5651,162
SATO,5811,40,24.80,5,21.00,24.19,5811,0
ITWO,5692,23,60.00,0,0.00,44.11,5626,66
MBCC,5420,0,0.00,0,0.00,35.93,4320,1100
IQDG,5369,0,0.00,0,0.00,35.99,5369,0
OUSM,5354,0,0.00,0,0.00,46.94,5354,0
JEMA,5278,0,0.00,0,0.00,38.45,5278,0
RSST,5250,0,0.00,1,22.50,24.06,5249,1
SDVD,5022,0,0.00,15,22.64,23.89,5022,0
DRSK,4902,0,0.00,0,0.00,27.88,4902,0
BNOV,4770,0,0.00,0,0.00,39.81,4770,0
CEMB,4764,0,0.00,0,0.00,45.26,4764,0
BUFF,4757,0,0.00,0,0.00,45.15,4757,0
BUYW,4738,0,0.00,36,13.80,13.80,4338,400
SYLD,4677,0,0.00,1,70.25,75.69,4677,0
DMAY,4568,0,0.00,0,0.00,41.08,4568,0
GSEW,4562,0,0.00,1,79.50,82.73,4562,0
ETHV,4479,4000,52.82,4000,52.34,52.52,4479,0
IBHG,4433,0,0.00,500,22.25,22.54,4433,0
PSMR,4428,0,0.00,0,0.00,28.20,4428,0
REGL,4423,0,0.00,0,0.00,88.36,4187,236
BUFQ,4421,0,0.00,0,0.00,31.32,4221,200
RSSY,4342,0,0.00,0,0.00,20.79,4342,0
VCRM,4256,0,0.00,100,75.76,75.99,4256,0
URAN,4236,0,0.00,100,27.50,34.48,4236,0
PFEB,4233,0,0.00,0,0.00,36.68,4233,0
JPIB,4208,0,0.00,0,0.00,48.01,4208,0
VTEC,4195,0,0.00,0,0.00,101.24,4195,0
FFLC,4043,0,0.00,2250,46.01,47.56,4043,0
WTAI,4023,0,0.00,1,21.47,21.89,4023,0
PBDE,3970,0,0.00,0,0.00,26.57,3970,0
EZET,3953,7500,27.41,7500,27.13,27.25,3953,0
MAXJ,3945,7,26.55,100,24.89,26.38,3945,0
JPLD,3932,1458,52.33,0,0.00,51.80,3932,0
BTCI,3822,0,0.00,50,63.00,62.85,3822,0
GOCT,3814,0,0.00,0,0.00,35.38,3814,0
NULG,3762,0,0.00,625,80.00,88.82,3762,0
NUSC,3633,0,0.00,0,0.00,45.98,3633,0
VSDM,3630,0,0.00,1,75.00,75.45,3630,0
IBHD,3398,0,0.00,0,0.00,23.28,3398,0
GSUS,3369,0,0.00,0,0.00,83.03,3369,0
PJAN,3368,0,0.00,0,0.00,42.01,3368,0
VAMO,3283,0,0.00,0,0.00,32.22,3283,0
SMOT,3084,0,0.00,1,36.00,37.18,3084,0
NFLU,3075,58,38.03,48,37.01,37.01,3075,0
FLDR,3043,0,0.00,20,50.06,50.06,3043,0
RMIF,2994,0,0.00,0,0.00,25.40,2994,0
FLQM,2957,0,0.00,10,49.80,58.63,2957,0
EWUS,2925,0,0.00,0,0.00,36.89,2925,0
NULV,2914,0,0.00,1,30.00,43.28,2834,80
SMMV,2894,0,0.00,0,0.00,44.35,2894,0
BBIB,2860,0,0.00,0,0.00,97.97,2860,0
HYMU,2825,0,0.00,0,0.00,23.20,2825,0
SMB,2808,0,0.00,0,0.00,17.22,2808,0
PTLC,2772,0,0.00,0,0.00,55.13,2772,0
IEO,2745,23,104.50,1,89.10,99.44,2745,0
HYGW,2718,106,32.65,3,31.90,32.55,2718,0
XMPT,2717,500,23.19,0,0.00,22.90,2717,0
MFUT,2632,0,0.00,0,0.00,16.96,2632,0
BUFD,2624,0,0.00,10,25.01,25.67,2624,0
IYJ,2619,12,145.00,0,0.00,143.93,2619,0
VCEB,2608,0,0.00,0,0.00,63.61,2608,0
FPAG,2600,0,0.00,0,0.00,31.34,2600,0
RSBT,2600,500,20.20,100,16.00,16.82,2600,0
FAUG,2591,0,0.00,0,0.00,47.01,2591,0
SHYD,2574,17,25.50,36,22.09,22.76,2374,200
KRUZ,2572,200,33.50,3,31.00,33.53,2572,0
PTMC,2567,0,0.00,0,0.00,40.12,2567,0
RDFI,2565,0,0.00,0,0.00,24.58,2565,0
OILK,2548,40,44.25,1,42.00,42.71,2548,0
IMFL,2487,0,0.00,0,0.00,24.56,2487,0
PBP,2485,0,0.00,0,0.00,23.24,2485,0
YETH,2420,2,54.00,25,48.10,53.65,2420,0
BUFY,2349,0,0.00,0,0.00,19.20,2349,0
TTAI,2319,0,0.00,0,0.00,29.86,2319,0
BUFS,2265,0,0.00,0,0.00,22.12,2265,0
IGE,2229,2,47.82,0,0.00,47.29,2229,0
IETC,2219,15,100.00,49,79.00,82.36,2219,0
BUFZ,2135,0,0.00,0,0.00,23.99,2135,0
IBMQ,2108,0,0.00,0,0.00,25.42,2108,0
PAPR,2038,0,0.00,10,35.70,36.92,2038,0
FDEM,2036,0,0.00,0,0.00,25.71,2036,0
GOOX,2026,400,30.10,62,29.57,29.87,2026,0
RSSB,2023,0,0.00,0,0.00,24.76,1723,300
BUFB,1999,0,0.00,0,0.00,32.62,1999,0
MEAR,1986,0,0.00,0,0.00,50.28,1986,0
XEMD,1974,0,0.00,0,0.00,42.36,1974,0
HEGD,1964,0,0.00,0,0.00,22.92,1964,0
DDLS,1948,0,0.00,0,0.00,34.88,1938,10
VEGN,1917,0,0.00,54,51.00,55.00,1917,0
FCLD,1907,0,0.00,10,29.00,29.14,870,1037
BBIN,1893,6,70.00,0,0.00,59.41,1893,0
NUMG,1890,0,0.00,0,0.00,50.80,1273,617
NUEM,1875,0,0.00,0,0.00,29.73,1875,0
IGRO,1808,0,0.00,11,69.72,71.19,1808,0
NUDM,1808,3,34.68,1,29.00,32.01,1808,0
FFLG,1799,0,0.00,0,0.00,25.39,1760,39
CAOS,1796,0,0.00,66,86.93,87.18,1796,0
IBMM,1788,4,26.14,0,0.00,26.12,1788,0
DJUN,1770,0,0.00,0,0.00,43.71,1770,0
NFLP,1752,0,0.00,1,33.00,34.00,1752,0
IBHI,1748,0,0.00,1,23.70,23.85,1748,0
XSHQ,1731,0,0.00,0,0.00,47.02,1731,0
DINT,1714,0,0.00,0,0.00,23.54,1714,0
NUMV,1702,0,0.00,0,0.00,38.29,1702,0
SECT,1692,0,0.00,0,0.00,56.63,1692,0
EYLD,1684,0,0.00,0,0.00,32.73,1684,0
HYXU,1655,0,0.00,0,0.00,50.32,1655,0
VFMF,1654,0,0.00,1,140.03,140.84,1654,0
QPFF,1606,0,0.00,0,0.00,37.82,1606,0
DDWM,1604,0,0.00,0,0.00,34.67,1604,0
FMAG,1601,0,0.00,1,31.60,32.88,1601,0
DOGG,1581,0,0.00,0,0.00,20.19,1581,0
BJUL,1577,0,0.00,0,0.00,45.25,1577,0
AAPX,1575,61,35.61,59,35.01,34.65,1575,0
FYLD,1556,0,0.00,0,0.00,26.28,1556,0
TDVI,1555,0,0.00,40,24.00,24.55,1554,1
SMDV,1537,0,0.00,0,0.00,74.89,1537,0
POCT,1530,0,0.00,0,0.00,39.84,1530,0
PRNT,1525,5,22.90,15,21.50,21.50,1525,0
CLSE,1524,20,23.60,10,23.26,23.55,1524,0
PJUN,1500,0,0.00,0,0.00,37.68,1500,0
RBUF,1500,0,0.00,0,0.00,27.22,1500,0
SMAY,1500,0,0.00,0,0.00,25.69,1500,0
SNAV,1498,0,0.00,0,0.00,32.17,1498,0
OUSA,1463,0,0.00,10,54.00,55.51,1273,190
EMTL,1429,0,0.00,0,0.00,42.83,1429,0
CEFS,1418,2394,22.61,3,22.18,22.46,1418,0
UJUL,1417,0,0.00,0,0.00,34.87,1417,0
IGLD,1378,2,21.77,0,0.00,20.77,1378,0
PJUL,1359,0,0.00,0,0.00,41.50,1359,0
XUSP,1357,0,0.00,0,0.00,42.00,1357,0
XJH,1355,0,0.00,0,0.00,45.54,1355,0
TLTP,1321,0,0.00,500,24.71,25.12,1321,0
INTL,1305,5,22.92,0,0.00,22.78,1305,0
ETU,1292,5,52.50,0,0.00,46.93,1292,0
OSCV,1273,0,0.00,0,0.00,40.66,1273,0
EDEN,1245,0,0.00,1,101.00,114.26,1245,0
GARP,1233,0,0.00,0,0.00,56.07,1233,0
MYLD,1214,0,0.00,0,0.00,28.19,1214,0
TMAT,1211,0,0.00,0,0.00,21.89,1211,0
ARKD,1206,0,0.00,49,36.00,53.75,1206,0
ACIO,1203,0,0.00,0,0.00,41.11,1203,0
EVUS,1200,0,0.00,0,0.00,31.09,1200,0
GSEP,1200,0,0.00,0,0.00,35.31,1200,0
TYLD,1198,0,0.00,0,0.00,25.35,1198,0
IBHJ,1177,0,0.00,0,0.00,26.67,1177,0
HYBL,1160,0,0.00,1000,28.50,28.72,1160,0
FLIA,1144,0,0.00,0,0.00,20.93,1144,0
SEIM,1107,0,0.00,0,0.00,40.42,1107,0
SNOV,1104,0,0.00,0,0.00,23.97,1104,0
NAPR,1103,0,0.00,0,0.00,50.13,1103,0
IBMR,1092,0,0.00,0,0.00,25.26,1092,0
VFVA,1091,0,0.00,3,105.00,128.92,1091,0
HFGO,1061,0,0.00,0,0.00,23.31,1061,0
EFNL,1050,0,0.00,0,0.00,33.40,1050,0
PAWZ,1041,0,0.00,1,55.71,56.85,1041,0
FDND,1037,0,0.00,5,17.21,22.38,1037,0
GVAL,1035,50,23.00,1000,20.75,21.06,1035,0
ZVOL,1015,20,20.71,100,20.70,20.74,915,100
YMAR,1013,0,0.00,0,0.00,23.16,1013,0
ATMP,1000,0,0.00,0,0.00,30.37,959,41
FRNW,978,0,0.00,0,0.00,14.79,978,0
TOKE,969,1,6.00,50,5.50,5.52,969,0
PBUS,968,0,0.00,1,60.57,60.60,858,110
QHY,943,1362,50.00,0,0.00,45.94,943,0
BBLB,936,0,0.00,1,77.09,88.92,936,0
XJAN,928,0,0.00,0,0.00,33.46,928,0
GAA,925,0,0.00,2000,29.00,29.29,925,0
HYHG,916,0,0.00,0,0.00,65.88,916,0
FLQL,914,0,0.00,0,0.00,60.56,914,0
DUBS,906,0,0.00,0,0.00,33.30,906,0
PSMO,906,0,0.00,0,0.00,27.88,906,0
ZECP,906,0,0.00,0,0.00,32.26,906,0
QJUN,901,0,0.00,0,0.00,27.86,901,0
FOCT,882,0,0.00,0,0.00,43.25,882,0
GEMD,880,0,0.00,0,0.00,41.31,880,0
BCHP,875,0,0.00,0,0.00,34.76,875,0
FJAN,875,0,0.00,0,0.00,45.72,875,0
FPRO,875,1,23.25,0,0.00,24.44,875,0
FCPI,862,0,0.00,0,0.00,46.46,862,0
IWMW,857,19,50.00,8,46.00,46.13,857,0
MSSS,848,0,0.00,0,0.00,29.82,848,0
VXZ,834,50,55.00,25,47.50,49.97,834,0
LQDW,827,100,27.42,199,27.05,27.41,638,189
FDEV,818,0,0.00,0,0.00,28.52,818,0
EPRF,811,0,0.00,0,0.00,19.39,811,0
UPSD,802,0,0.00,23,25.20,25.60,802,0
APOC,800,0,0.00,0,0.00,25.52,800,0
FHDG,800,0,0.00,0,0.00,30.87,800,0
IDUB,800,0,0.00,0,0.00,21.00,800,0
MOTI,792,2,33.70,0,0.00,32.42,792,0
BAMY,789,0,0.00,0,0.00,26.94,789,0
QVOY,782,0,0.00,0,0.00,28.82,782,0
SAUG,780,0,0.00,0,0.00,24.32,780,0
QCON,747,0,0.00,0,0.00,47.31,747,0
VFMV,743,0,0.00,0,0.00,127.81,743,0
WEED,742,50,33.00,80,18.88,20.26,742,0
QETH,729,5700,36.02,5700,35.64,35.80,729,0
SMAX,718,0,0.00,0,0.00,25.24,718,0
YSEP,713,0,0.00,0,0.00,21.98,713,0
FFSM,711,0,0.00,0,0.00,29.37,711,0
UAUG,707,0,0.00,0,0.00,35.79,707,0
LIMI,703,0,0.00,0,0.00,30.75,703,0
PSCX,700,0,0.00,0,0.00,27.68,700,0
UFEB,665,0,0.00,0,0.00,33.10,665,0
RULE,663,0,0.00,0,0.00,23.43,663,0
IZRL,653,15,22.11,20,21.70,21.99,653,0
IBHH,648,0,0.00,0,0.00,23.82,648,0
GOOP,647,6,29.40,0,0.00,27.94,647,0
MSMR,641,0,0.00,0,0.00,31.62,641,0
OEUR,641,0,0.00,0,0.00,29.30,552,89
TSLP,636,0,0.00,2,26.90,27.72,636,0
AOCT,614,0,0.00,0,0.00,25.01,614,0
DWLD,606,0,0.00,100,35.00,38.67,606,0
HSRT,606,0,0.00,50,34.79,39.05,606,0
GFEB,605,0,0.00,0,0.00,37.30,605,0
IBMN,604,0,0.00,0,0.00,26.66,604,0
PSDM,600,0,0.00,0,0.00,51.04,600,0
PSFO,600,0,0.00,0,0.00,29.01,600,0
QCJL,600,0,0.00,0,0.00,20.90,600,0
QTJL,600,0,0.00,0,0.00,32.35,600,0
XIMR,600,0,0.00,0,0.00,31.23,600,0
MSTB,590,0,0.00,0,0.00,35.10,590,0
DNOV,570,0,0.00,0,0.00,43.35,570,0
XBAP,569,0,0.00,0,0.00,34.06,569,0
EFAD,566,0,0.00,0,0.00,38.90,566,0
UAPR,565,0,0.00,0,0.00,31.09,565,0
NVBU,544,0,0.00,0,0.00,26.16,544,0
BLKC,541,0,0.00,5,21.00,28.40,541,0
BOCT,540,0,0.00,0,0.00,43.78,540,0
FNOV,528,0,0.00,0,0.00,48.45,528,0
UNOV,525,0,0.00,0,0.00,34.87,525,0
GDMN,522,0,0.00,2,31.14,31.68,522,0
KJAN,520,0,0.00,0,0.00,39.48,520,0
FFEB,515,0,0.00,0,0.00,49.88,515,0
EALT,513,0,0.00,0,0.00,32.94,513,0
RSBY,508,0,0.00,0,0.00,18.71,508,0
DSCF,501,8,24.24,10,22.25,23.10,501,0
IBMO,501,5,28.00,0,0.00,25.57,501,0
DECP,500,0,0.00,0,0.00,26.90,500,0
DSEP,500,0,0.00,0,0.00,40.78,500,0
TFJL,500,0,0.00,0,0.00,20.25,100,400
MAGA,499,0,0.00,0,0.00,55.15,499,0
GOLY,487,80,25.75,0,0.00,24.89,487,0
QUVU,474,0,0.00,0,0.00,27.09,474,0
WBAT,466,0,0.00,0,0.00,28.39,466,0
DAUG,462,0,0.00,0,0.00,39.99,462,0
SVAL,457,0,0.00,10,31.00,35.73,457,0
VFQY,457,3,150.80,16,129.56,149.13,457,0
PMAR,450,0,0.00,0,0.00,40.17,450,0
IGHG,449,0,0.00,0,0.00,78.02,449,0
TMFG,449,4,40.00,100,32.50,33.59,449,0
FJUL,446,0,0.00,0,0.00,49.50,446,0
GTIP,445,1,60.00,0,0.00,49.16,445,0
JUCY,442,100,23.41,100,22.88,22.98,442,0
BAMA,440,0,0.00,0,0.00,31.38,439,1
OVL,428,0,0.00,0,0.00,48.51,428,0
IBMP,427,0,0.00,25,25.00,25.33,427,0
FBCV,425,0,0.00,0,0.00,34.18,425,0
FDRV,423,4,14.00,1,12.93,13.11,423,0
GAUG,422,0,0.00,0,0.00,35.47,422,0
BSEP,416,0,0.00,0,0.00,42.26,316,100
COPA,400,0,0.00,0,0.00,25.02,400,0
HIYS,400,0,0.00,0,0.00,25.74,400,0
MSFY,398,0,0.00,100,25.00,25.71,398,0
PSEP,368,0,0.00,0,0.00,39.37,269,99
ROMO,368,0,0.00,0,0.00,32.63,368,0
OMFS,356,0,0.00,10,43.64,43.76,263,93
BGLD,355,0,0.00,0,0.00,23.07,355,0
FFOG,353,0,0.00,0,0.00,39.71,353,0
FMAR,351,0,0.00,0,0.00,43.49,351,0
EMGF,344,0,0.00,2,45.29,47.22,344,0
ENOR,343,0,0.00,0,0.00,24.18,343,0
TTAC,338,0,0.00,0,0.00,70.08,338,0
USEP,337,0,0.00,0,0.00,35.46,337,0
OCTM,334,0,0.00,0,0.00,30.57,334,0
TOLL,332,0,0.00,0,0.00,34.01,332,0
ZALT,330,0,0.00,0,0.00,29.95,330,0
BAMD,325,0,0.00,0,0.00,34.59,325,0
ARKZ,323,0,0.00,50,27.00,40.61,323,0
TMFM,322,0,0.00,0,0.00,33.20,322,0
DUSA,321,0,0.00,0,0.00,44.95,321,0
GMOM,320,0,0.00,0,0.00,30.50,320,0
NJUL,317,0,0.00,0,0.00,62.48,317,0
IYLD,310,104,23.50,0,0.00,20.19,310,0
BWTG,308,0,0.00,60,34.17,35.80,308,0
BUSA,307,0,0.00,20,31.75,33.98,307,0
HELX,305,0,0.00,0,0.00,31.10,305,0
HEEM,301,0,0.00,0,0.00,27.51,301,0
BBEM,300,0,0.00,0,0.00,52.41,100,200
NUDV,300,0,0.00,0,0.00,30.92,300,0
OVF,300,0,0.00,0,0.00,24.77,300,0
PAUG,300,0,0.00,0,0.00,38.78,300,0
PIEQ,300,0,0.00,0,0.00,24.64,300,0
FDEC,295,0,0.00,0,0.00,44.65,295,0
TRTY,294,0,0.00,10,24.20,26.37,294,0
WUGI,292,59,80.00,0,0.00,74.40,292,0
AMZP,289,0,0.00,0,0.00,30.31,289,0
OGIG,286,1,47.85,10,44.85,47.32,286,0
HCRB,274,0,0.00,0,0.00,35.24,274,0
ARKY,272,0,0.00,1,34.00,39.88,272,0
DURA,268,0,0.00,0,0.00,35.06,168,100
GSEE,267,0,0.00,0,0.00,45.00,267,0
XBJA,250,0,0.00,0,0.00,28.64,250,0
GLOV,245,0,0.00,0,0.00,51.76,245,0
PNOV,244,0,0.00,0,0.00,38.19,244,0
KNOV,242,0,0.00,0,0.00,26.29,242,0
GHYG,241,0,0.00,0,0.00,45.00,241,0
TJUL,234,0,0.00,0,0.00,27.74,234,0
TDV,229,0,0.00,10,75.36,77.86,229,0
IBHK,228,0,0.00,0,0.00,25.89,228,0
PMAY,220,0,0.00,0,0.00,35.94,220,0
BALI,218,0,0.00,12,30.54,31.49,218,0
TGLR,213,0,0.00,0,0.00,31.05,213,0
FJUN,210,0,0.00,0,0.00,52.03,210,0
PSMD,206,0,0.00,0,0.00,29.13,206,0
KOCT,204,0,0.00,0,0.00,31.66,110,94
QBER,204,0,0.00,0,0.00,24.96,204,0
TILT,204,0,0.00,1,198.00,226.44,204,0
QSIG,203,0,0.00,0,0.00,48.38,203,0
QMAR,202,0,0.00,0,0.00,29.68,202,0
DJUL,200,0,0.00,0,0.00,42.42,200,0
HSBH,200,0,0.00,0,0.00,53.22,200,0
KAUG,200,0,0.00,0,0.00,26.26,100,100
KSEP,200,0,0.00,0,0.00,26.62,200,0
MVAL,200,0,0.00,0,0.00,34.35,200,0
SFEB,200,0,0.00,0,0.00,22.45,200,0
UDEC,200,0,0.00,0,0.00,35.48,200,0
GDE,190,0,0.00,29,36.60,38.46,190,0
GJUN,190,0,0.00,0,0.00,36.28,190,0
JANZ,185,0,0.00,1,32.41,35.99,185,0
IVRA,179,0,0.00,1,16.85,17.25,179,0
BRLN,177,500,52.90,48,52.38,52.80,177,0
IEDI,172,0,0.00,1,54.50,55.80,172,0
ARKA,160,1,71.00,1,50.00,66.42,160,0
IBMS,156,0,0.00,0,0.00,25.70,156,0
LQDI,156,0,0.00,0,0.00,26.26,156,0
DFNL,152,0,0.00,0,0.00,41.40,152,0
PWS,144,0,0.00,4,28.82,31.57,144,0
BUFG,142,0,0.00,0,0.00,24.81,142,0
PEX,135,0,0.00,50,23.38,29.07,135,0
BAMB,130,0,0.00,0,0.00,25.94,130,0
USMF,130,6,56.00,0,0.00,52.67,130,0
DAPR,127,0,0.00,0,0.00,37.20,127,0
UMAY,126,0,0.00,0,0.00,33.73,126,0
BUFT,124,0,0.00,0,0.00,22.40,124,0
ESG,124,0,0.00,0,0.00,141.97,124,0
OVM,115,0,0.00,0,0.00,22.57,115,0
SNPG,115,0,0.00,0,0.00,45.75,115,0
BJAN,114,0,0.00,0,0.00,47.64,114,0
SEIV,114,0,0.00,0,0.00,34.94,114,0
AZNH,111,0,0.00,0,0.00,45.16,111,0
OCTU,111,0,0.00,0,0.00,25.86,111,0
UJUN,111,0,0.00,0,0.00,34.00,111,0
AAPR,110,0,0.00,0,0.00,26.44,35,75
LKOR,110,0,0.00,0,0.00,44.23,110,0
FLQS,109,0,0.00,0,0.00,45.67,109,0
AESR,108,0,0.00,0,0.00,17.79,108,0
UOCT,104,0,0.00,0,0.00,35.56,104,0
TMDV,103,0,0.00,0,0.00,51.62,103,0
BAPR,102,0,0.00,0,0.00,44.88,102,0
OVT,102,0,0.00,0,0.00,22.47,102,0
XAUG,102,0,0.00,0,0.00,34.25,102,0
OVB,101,0,0.00,0,0.00,21.06,101,0
ADME,100,0,0.00,0,0.00,47.90,100,0
BINV,100,0,0.00,0,0.00,30.40,100,0
FCTR,100,0,0.00,0,0.00,35.11,100,0
GDMA,100,0,0.00,0,0.00,33.12,100,0
GJAN,100,0,0.00,0,0.00,38.48,100,0
MFUL,100,0,0.00,0,0.00,22.16,100,0
TBJL,100,0,0.00,0,0.00,20.37,100,0
OCTH,95,0,0.00,0,0.00,24.27,95,0
JULH,92,0,0.00,0,0.00,25.29,92,0
FMAY,90,0,0.00,0,0.00,47.84,90,0
BAMO,89,0,0.00,0,0.00,30.91,89,0
ESGG,85,7,178.00,0,0.00,173.36,85,0
IVVW,84,0,0.00,0,0.00,48.26,44,40
GUNZ,83,0,0.00,5,30.57,29.54,83,0
JULZ,82,0,0.00,0,0.00,43.97,82,0
CMCI,80,0,0.00,0,0.00,25.13,80,0
BKGI,78,0,0.00,0,0.00,32.20,78,0
SEPZ,77,0,0.00,0,0.00,40.39,77,0
JULJ,72,0,0.00,0,0.00,25.18,72,0
MARZ,72,0,0.00,100,33.31,33.51,72,0
OCTJ,71,0,0.00,0,0.00,24.20,71,0
BJUN,68,0,0.00,0,0.00,41.89,68,0
BBSB,65,0,0.00,0,0.00,95.49,65,0
UJAN,64,0,0.00,0,0.00,38.66,64,0
HAUS,61,0,0.00,1,17.00,20.32,61,0
YDEC,60,0,0.00,0,0.00,23.33,60,0
BAMG,58,0,0.00,0,0.00,35.51,58,0
FIBR,55,0,0.00,0,0.00,87.74,55,0
DDEC,50,0,0.00,0,0.00,40.16,50,0
HSUN,49,0,0.00,0,0.00,35.01,49,0
SHAG,45,0,0.00,0,0.00,47.46,45,0
QBUL,43,0,0.00,0,0.00,25.40,43,0
BMAY,42,0,0.00,0,0.00,40.44,42,0
EAOK,42,1,27.15,0,0.00,26.19,42,0
FFEM,42,0,0.00,0,0.00,24.77,42,0
NNOV,42,0,0.00,0,0.00,25.73,42,0
PSFD,41,0,0.00,0,0.00,32.94,41,0
XDEC,39,0,0.00,0,0.00,37.17,39,0
OVS,38,0,0.00,0,0.00,38.83,38,0
ARKC,37,0,0.00,0,0.00,43.25,37,0
BMAR,37,0,0.00,0,0.00,46.41,37,0
PBTP,35,0,0.00,0,0.00,25.54,35,0
KWT,34,0,0.00,1,31.75,32.69,34,0
QCAP,34,0,0.00,0,0.00,22.02,34,0
XBOC,34,0,0.00,0,0.00,29.62,34,0
IVVM,33,0,0.00,0,0.00,31.31,33,0
OBND,32,0,0.00,0,0.00,26.20,32,0
JAND,31,0,0.00,0,0.00,25.05,31,0
JULD,31,0,0.00,0,0.00,25.43,31,0
XJUL,31,0,0.00,0,0.00,35.75,31,0
EGUS,29,0,0.00,0,0.00,43.96,29,0
KAPR,29,0,0.00,0,0.00,34.28,29,0
PSFJ,29,0,0.00,0,0.00,29.41,29,0
PSFM,27,0,0.00,0,0.00,29.88,27,0
STBF,27,0,0.00,0,0.00,25.36,27,0
DFNV,26,0,0.00,0,0.00,37.06,26,0
FSEP,26,0,0.00,0,0.00,46.21,26,0
QDEC,26,0,0.00,0,0.00,27.58,26,0
GJUL,25,0,0.00,0,0.00,36.89,25,0
JANQ,25,0,0.00,0,0.00,24.90,25,0
BUYZ,23,10,39.00,1,30.00,38.53,23,0
ZSEP,23,0,0.00,0,0.00,25.08,23,0
ETQ,22,1100,9.81,1100,9.18,9.50,22,0
GMAY,22,0,0.00,0,0.00,37.12,22,0
IMSI,22,0,0.00,0,0.00,51.55,22,0
MIG,21,0,0.00,0,0.00,21.63,21,0
NJAN,20,0,0.00,0,0.00,47.68,20,0
RYSE,20,0,0.00,0,0.00,23.54,20,0
AFIF,19,0,0.00,1,8.88,9.20,19,0
DWAT,18,0,0.00,0,0.00,12.01,18,0
XSEP,18,0,0.00,0,0.00,39.06,17,1
DECZ,17,0,0.00,0,0.00,38.61,17,0
FFLV,17,0,0.00,0,0.00,23.42,17,0
QLC,15,0,0.00,0,0.00,68.07,15,0
FDCE,14,0,0.00,0,0.00,13.40,14,0
SNPV,14,0,0.00,0,0.00,33.81,14,0
XDAP,13,0,0.00,0,0.00,35.65,13,0
CVAR,12,0,0.00,0,0.00,27.85,12,0
XVOL,12,0,0.00,0,0.00,24.18,12,0
ESGX,11,0,0.00,1,26.29,26.60,11,0
EUDV,11,0,0.00,0,0.00,48.60,11,0
FDGR,11,0,0.00,0,0.00,13.95,11,0
MGRO,11,0,0.00,3,30.67,31.63,11,0
UMAR,11,0,0.00,0,0.00,35.74,11,0
NURE,9,0,0.00,0,0.00,34.61,9,0
QSPT,9,0,0.00,0,0.00,27.50,9,0
SEIQ,9,0,0.00,0,0.00,36.51,9,0
APRJ,8,0,0.00,0,0.00,24.94,8,0
TAIL,8,0,0.00,0,0.00,11.37,8,0
XDOC,8,0,0.00,0,0.00,30.72,8,0
FDVL,7,0,0.00,0,0.00,13.58,7,0
AJUL,6,0,0.00,0,0.00,27.03,6,0
MOTG,6,0,0.00,0,0.00,39.65,6,0
QMAG,6,0,0.00,0,0.00,20.85,6,0
STOT,6,0,0.00,0,0.00,47.18,6,0
DJAN,5,0,0.00,0,0.00,38.88,5,0
FDHT,5,0,0.00,0,0.00,21.55,5,0
LEAD,5,0,0.00,0,0.00,70.99,5,0
RTAI,5,0,0.00,0,0.00,22.50,5,0
XDAT,5,0,0.00,1,25.25,27.11,5,0
BAMV,4,0,0.00,0,0.00,33.13,4,0
DOCT,4,0,0.00,0,0.00,39.75,4,0
OCTD,4,0,0.00,0,0.00,24.38,4,0
OCTQ,4,0,0.00,0,0.00,24.07,4,0
QCOC,4,0,0.00,0,0.00,20.08,4,0
AAPY,3,0,0.00,0,0.00,27.87,3,0
IPDP,3,0,0.00,0,0.00,21.73,3,0
SNPD,3,0,0.00,0,0.00,28.25,3,0
XISE,3,0,0.00,0,0.00,30.00,3,0
DFEB,2,0,0.00,0,0.00,42.75,2,0
DFND,2,1,43.07,0,0.00,42.52,2,0
EVLU,2,0,0.00,0,0.00,24.61,2,0
GAPR,2,0,0.00,0,0.00,37.48,2,0
IQM,2,0,0.00,3757,17.83,67.75,2,0
LIAX,2,0,0.00,0,0.00,27.46,2,0
MOTE,2,0,0.00,0,0.00,29.99,2,0
PIT,2,0,0.00,0,0.00,48.35,2,0
PSCW,2,0,0.00,0,0.00,26.56,2,0
XDJL,2,0,0.00,0,0.00,35.09,2,0
XJR,2,0,0.00,1,37.00,44.97,2,0
ACSI,1,0,0.00,1,61.55,62.50,1,0
AJAN,1,0,0.00,0,0.00,26.58,1,0
BEMB,1,0,0.00,1,51.59,53.04,1,0
BFEB,1,0,0.00,0,0.00,42.95,1,0
BLDG,1,0,0.00,0,0.00,27.08,1,0
DFRA,1,0,0.00,0,0.00,32.42,1,0
DWCR,1,0,0.00,0,0.00,29.14,1,0
EAOA,1,0,0.00,2,31.86,36.90,1,0
FUNL,1,0,0.00,0,0.00,44.84,1,0
GPOW,1,0,0.00,0,0.00,56.98,1,0
ISVL,1,0,0.00,0,0.00,35.91,1,0
JANJ,1,0,0.00,0,0.00,25.14,1,0
LBO,1,0,0.00,100,32.70,34.46,1,0
MBBB,1,0,0.00,0,0.00,21.72,1,0
NOVZ,1,0,0.00,0,0.00,41.97,1,0
NSEP,1,0,0.00,0,0.00,25.55,1,0
NULC,1,0,0.00,0,0.00,48.75,1,0
PSMJ,1,0,0.00,0,0.00,28.65,1,0
QIG,1,0,0.00,0,0.00,44.90,1,0
RPHS,1,0,0.00,0,0.00,10.67,1,0
TUSI,1,0,0.00,0,0.00,25.35,1,0
XDJA,1,0,0.00,0,0.00,29.78,1,0
XDQQ,1,0,0.00,0,0.00,33.64,1,0
APRD,0,0,0.00,0,0.00,0.00,0,0
APRH,0,1,29.44,5,24.00,0.00,0,0
APRP,0,0,0.00,0,0.00,0.00,0,0
APRQ,0,0,0.00,0,0.00,0.00,0,0
APRZ,0,0,0.00,0,0.00,0.00,0,0
ARCM,0,0,0.00,0,0.00,0.00,0,0
ARLU,0,0,0.00,0,0.00,0.00,0,0
AUGM,0,0,0.00,0,0.00,0.00,0,0
AUGP,0,0,0.00,0,0.00,0.00,0,0
AUGU,0,0,0.00,0,0.00,0.00,0,0
AUGZ,0,0,0.00,0,0.00,0.00,0,0
BAMU,0,0,0.00,0,0.00,0.00,0,0
BAUG,0,0,0.00,0,0.00,0.00,0,0
BHYB,0,0,0.00,0,0.00,0.00,0,0
BSMC,0,0,0.00,0,0.00,0.00,0,0
BUFP,0,0,0.00,0,0.00,0.00,0,0
CNAV,0,0,0.00,0,0.00,0.00,0,0
CPSL,0,0,0.00,0,0.00,0.00,0,0
CSM,0,0,0.00,0,0.00,0.00,0,0
DFHY,0,0,0.00,0,0.00,0.00,0,0
DHDG,0,0,0.00,0,0.00,0.00,0,0
DMAR,0,0,0.00,0,0.00,0.00,0,0
EAOM,0,0,0.00,0,0.00,0.00,0,0
EAOR,0,0,0.00,2,28.83,0.00,0,0
EMDV,0,2,45.00,0,0.00,0.00,0,0
EQLT,0,0,0.00,0,0.00,0.00,0,0
FAIL,0,225,16.65,0,0.00,0.00,0,0
FAPR,0,0,0.00,0,0.00,0.00,0,0
FBUF,0,0,0.00,0,0.00,0.00,0,0
FDTB,0,0,0.00,0,0.00,0.00,0,0
FEBP,0,0,0.00,0,0.00,0.00,0,0
FEBZ,0,0,0.00,0,0.00,0.00,0,0
FFDI,0,0,0.00,0,0.00,0.00,0,0
FFGX,0,0,0.00,0,0.00,0.00,0,0
FHEQ,0,0,0.00,0,0.00,0.00,0,0
FLDZ,0,0,0.00,0,0.00,0.00,0,0
FPAS,0,0,0.00,0,0.00,0.00,0,0
FYEE,0,0,0.00,0,0.00,0.00,0,0
GCLN,0,0,0.00,0,0.00,0.00,0,0
GDEC,0,0,0.00,0,0.00,0.00,0,0
GHMS,0,0,0.00,0,0.00,0.00,0,0
GHTA,0,0,0.00,0,0.00,0.00,0,0
GLBL,0,0,0.00,0,0.00,0.00,0,0
GMAR,0,0,0.00,0,0.00,0.00,0,0
GSID,0,0,0.00,0,0.00,0.00,0,0
HEAT,0,0,0.00,0,0.00,0.00,0,0
HJAN,0,0,0.00,0,0.00,0.00,0,0
HYKE,0,0,0.00,0,0.00,0.00,0,0
IPAV,0,0,0.00,0,0.00,0.00,0,0
IPPP,0,0,0.00,0,0.00,0.00,0,0
ISDB,0,0,0.00,0,0.00,0.00,0,0
JAJL,0,0,0.00,0,0.00,0.00,0,0
JANH,0,0,0.00,0,0.00,0.00,0,0
JANP,0,0,0.00,0,0.00,0.00,0,0
JNEU,0,0,0.00,0,0.00,0.00,0,0
JULM,0,0,0.00,0,0.00,0.00,0,0
JULP,0,0,0.00,0,0.00,0.00,0,0
JULQ,0,0,0.00,0,0.00,0.00,0,0
JULU,0,0,0.00,0,0.00,0.00,0,0
JUNM,0,0,0.00,0,0.00,0.00,0,0
JUNP,0,0,0.00,0,0.00,0.00,0,0
JUNZ,0,0,0.00,0,0.00,0.00,0,0
KHPI,0,0,0.00,0,0.00,0.00,0,0
KJUL,0,0,0.00,0,0.00,0.00,0,0
KJUN,0,0,0.00,0,0.00,0.00,0,0
KNOW,0,0,0.00,0,0.00,0.00,0,0
LCF,0,0,0.00,0,0.00,0.00,0,0
LFAE,0,0,0.00,0,0.00,0.00,0,0
LFAF,0,0,0.00,0,0.00,0.00,0,0
LFAI,0,0,0.00,0,0.00,0.00,0,0
LFAJ,0,0,0.00,0,0.00,0.00,0,0
LFAK,0,0,0.00,0,0.00,0.00,0,0
LFAL,0,0,0.00,0,0.00,0.00,0,0
LFAN,0,0,0.00,0,0.00,0.00,0,0
LFAO,0,0,0.00,0,0.00,0.00,0,0
LFAQ,0,0,0.00,0,0.00,0.00,0,0
LFAR,0,0,0.00,0,0.00,0.00,0,0
LFAU,0,0,0.00,0,0.00,0.00,0,0
LFAV,0,0,0.00,0,0.00,0.00,0,0
LFAW,0,0,0.00,0,0.00,0.00,0,0
LFAX,0,0,0.00,0,0.00,0.00,0,0
LFAZ,0,0,0.00,0,0.00,0.00,0,0
LFBB,0,0,0.00,0,0.00,0.00,0,0
LIAB,0,0,0.00,0,0.00,0.00,0,0
LIAC,0,0,0.00,0,0.00,0.00,0,0
LIAE,0,0,0.00,0,0.00,0.00,0,0
LIAF,0,0,0.00,0,0.00,0.00,0,0
LIAG,0,0,0.00,0,0.00,0.00,0,0
LIAJ,0,0,0.00,0,0.00,0.00,0,0
LIAK,0,0,0.00,0,0.00,0.00,0,0
LIAM,0,0,0.00,0,0.00,0.00,0,0
LIAO,0,0,0.00,0,0.00,0.00,0,0
LIAP,0,0,0.00,0,0.00,0.00,0,0
LIAQ,0,0,0.00,0,0.00,0.00,0,0
LIAT,0,0,0.00,0,0.00,0.00,0,0
LIAU,0,0,0.00,0,0.00,0.00,0,0
LIAV,0,0,0.00,0,0.00,0.00,0,0
LIAW,0,0,0.00,0,0.00,0.00,0,0
LJAN,0,0,0.00,0,0.00,0.00,0,0
LJUL,0,0,0.00,0,0.00,0.00,0,0
LYLD,0,0,0.00,0,0.00,0.00,0,0
MARM,0,0,0.00,0,0.00,0.00,0,0
MAYP,0,0,0.00,0,0.00,0.00,0,0
MAYU,0,0,0.00,0,0.00,0.00,0,0
MAYZ,0,0,0.00,0,0.00,0.00,0,0
MBND,0,0,0.00,0,0.00,0.00,0,0
MBNE,0,0,0.00,0,0.00,0.00,0,0
MDEV,0,0,0.00,0,0.00,0.00,0,0
MDLV,0,0,0.00,0,0.00,0.00,0,0
MDPL,0,0,0.00,0,0.00,0.00,0,0
MINN,0,0,0.00,0,0.00,0.00,0,0
MRCP,0,0,0.00,0,0.00,0.00,0,0
MRGR,0,0,0.00,3,41.00,0.00,0,0
MSTQ,0,0,0.00,0,0.00,0.00,0,0
MSVX,0,0,0.00,0,0.00,0.00,0,0
MVFD,0,0,0.00,0,0.00,0.00,0,0
MVFG,0,0,0.00,0,0.00,0.00,0,0
NAUG,0,0,0.00,0,0.00,0.00,0,0
NDOW,0,0,0.00,0,0.00,0.00,0,0
NJUN,0,0,0.00,0,0.00,0.00,0,0
NOCT,0,0,0.00,0,0.00,0.00,0,0
NOVP,0,0,0.00,0,0.00,0.00,0,0
NXTI,0,0,0.00,0,0.00,0.00,0,0
NXTV,0,0,0.00,0,0.00,0.00,0,0
OCTP,0,0,0.00,0,0.00,0.00,0,0
OCTZ,0,0,0.00,0,0.00,0.00,0,0
OVLH,0,0,0.00,0,0.00,0.00,0,0
PBAP,0,0,0.00,0,0.00,0.00,0,0
PBAU,0,0,0.00,0,0.00,0.00,0,0
PBFB,0,0,0.00,0,0.00,0.00,0,0
PBFR,0,0,0.00,0,0.00,0.00,0,0
PBJA,0,0,0.00,0,0.00,0.00,0,0
PBJL,0,0,0.00,0,0.00,0.00,0,0
PBJN,0,0,0.00,0,0.00,0.00,0,0
PBL,0,0,0.00,0,0.00,0.00,0,0
PBMR,0,0,0.00,0,0.00,0.00,0,0
PBMY,0,0,0.00,0,0.00,0.00,0,0
PBNV,0,0,0.00,0,0.00,0.00,0,0
PBOC,0,0,0.00,0,0.00,0.00,0,0
PBSE,0,0,0.00,0,0.00,0.00,0,0
PJBF,0,0,0.00,0,0.00,0.00,0,0
PJFM,0,0,0.00,0,0.00,0.00,0,0
PSCJ,0,0,0.00,0,0.00,0.00,0,0
PSCQ,0,0,0.00,0,0.00,0.00,0,0
PSH,0,0,0.00,0,0.00,0.00,0,0
PTEU,0,0,0.00,0,0.00,0.00,0,0
PUTD,0,0,0.00,3,22.41,0.00,0,0
QMMY,0,0,0.00,0,0.00,0.00,0,0
QTAP,0,0,0.00,0,0.00,0.00,0,0
QTJA,0,0,0.00,0,0.00,0.00,0,0
QTOC,0,0,0.00,0,0.00,0.00,0,0
RODE,0,0,0.00,6,25.00,0.00,0,0
ROIS,0,0,0.00,0,0.00,0.00,0,0
RSEE,0,0,0.00,0,0.00,0.00,0,0
RTRE,0,0,0.00,0,0.00,0.00,0,0
RVRB,0,0,0.00,0,0.00,0.00,0,0
SCLZ,0,0,0.00,0,0.00,0.00,0,0
SELV,0,0,0.00,0,0.00,0.00,0,0
SEPM,0,0,0.00,0,0.00,0.00,0,0
SEPP,0,0,0.00,0,0.00,0.00,0,0
SEPU,0,0,0.00,0,0.00,0.00,0,0
SHDG,0,0,0.00,0,0.00,0.00,0,0
SHEH,0,0,0.00,0,0.00,0.00,0,0
SMI,0,0,0.00,0,0.00,0.00,0,0
SPCZ,0,0,0.00,0,0.00,0.00,0,0
SPIN,0,0,0.00,0,0.00,0.00,0,0
SPMV,0,0,0.00,0,0.00,0.00,0,0
TRSY,0,0,0.00,0,0.00,0.00,0,0
TSEP,0,0,0.00,0,0.00,0.00,0,0
UXOC,0,0,0.00,0,0.00,0.00,0,0
VMAX,0,0,0.00,0,0.00,0.00,0,0
VWID,0,0,0.00,1,25.00,0.00,0,0
WDNA,0,100,24.00,0,0.00,0.00,0,0
WEIX,0,0,0.00,0,0.00,0.00,0,0
WLDR,0,0,0.00,0,0.00,0.00,0,0
XAPR,0,0,0.00,0,0.00,0.00,0,0
XBJL,0,0,0.00,0,0.00,0.00,0,0
XDSQ,0,0,0.00,0,0.00,0.00,0,0
XFEB,0,0,0.00,0,0.00,0.00,0,0
XIDE,0,0,0.00,0,0.00,0.00,0,0
XJUN,0,0,0.00,0,0.00,0.00,0,0
XMAR,0,0,0.00,0,0.00,0.00,0,0
XMAY,0,0,0.00,0,0.00,0.00,0,0
XOCT,0,0,0.00,0,0.00,0.00,0,0
XTAP,0,0,0.00,0,0.00,0.00,0,0
XTJA,0,0,0.00,0,0.00,0.00,0,0
XTJL,0,0,0.00,0,0.00,0.00,0,0
XTOC,0,0,0.00,0,0.00,0.00,0,0
YJUN,0,0,0.00,0,0.00,0.00,0,0
ZAUG,0,0,0.00,0,0.00,0.00,0,0
ZJUL,0,0,0.00,0,0.00,0.00,0,0
ZNOV,0,0,0.00,0,0.00,0.00,0,0
ZOCT,0,0,0.00,0,0.00,0.00,0,0